###########################
#                         #
#                         #
#                         #
#      ###                #
#      #  #               #
#      #  #               #
#      ####               #
#      #  #               #
#      ###                #
#                         #
#                         #
#                         #
#                         #
###########################