###########################
#                         #
#                         #
#                         #
#     #                   #
#      #                  #
#       #                 #
#        # LLLLL          #
#          LLLLL #        #
#                 #       #
#                  #      #
#                   #     #
#                         #
#                         #
###########################