###########################
#                         #
#                         #
#                         #
#        ########         #
#                    LLL  #
#                         #
#                         #
#                         #
#                         #
#        ########         #
# LLLL                    #
#                         #
#                         #
###########################