###########################
#                         #
#                         #
#                         #
#                         #
#                         #
#                         #
#  #                      #
#                         #
#                         #
#                         #
#                         #
#                         #
#                         #
###########################