###########################
#                         #
#                         #
#                         #
#        ########         #
#                         #
#                         #
#    LL          LL       #
#                         #
#                         #
#        ########         #
#                         #
#                         #
#                         #
###########################