###########################
#                         #
#                         #
#                         #
#                         #
#    ###                  #
#                         #
#                         #
#                         #
#                         #
#                         #
#                         #
#                         #
#                         #
###########################