###########################
#                         #
#                         #
#                 #       #
#                 #       #
#                 #       #
#      #####              #
#                         #
#                         #
#                         #
#      #####              #
#                         #
#                         #
#                         #
###########################