###########################
#                         #
#                         #
#                         #
#          L    L         #
#                         #
#            LL           #
#       L    LL  L        #
#             L           #
#                         #
#          L     L        #
#                         #
#                         #
#                         #
###########################