###########################
#                         #
#                         #
#                         #
#                         #
#                         #
#      ##       L         #
#      ##                 #
#                         #
#                         #
#                         #
#                         #
#                         #
#                         #
###########################