############   ############
#                         #
#                         #
#                         #
#                         #
#    ###                   



#                         #
#                         #
#                         #
#                         #
#                         #
############   ############