###########################
#                         #
#                         #
#                         #
#                         #
#                         #

  #

#                         #
#                         #
#                         #
#                         #
#                         #
##########      ###########